BBBBBBBBBBBBBBBBBBBBBBBB
BBJBBPBBBBBBBBBBBBBBBBBB
BBBBBPBBBBBBBBMBBPBBBBBB
BBBBBPBBBBBBBBBBBBBBBBBB
BBBBBBBMBBBBBBBBBBBBBBBB
BBBBBBBBBBBBBBPPPPPPPPBB
BBBBBBBBBBBBBBBBBBMBBBBB
BBPBBBBBMBBBBBBMBBBBBBBB
BBBBBBBBBBBBBBBBBBBBBBBB
BBBBBBBBBBBPBBBBBBBBBBBB
BBBMBBBBBBBPBBBBBBBBBBBB
BBBBBBBBBBBPBBBBBBBBBBBB
PPPPPPPBBBBPBBBBBBBBBBBB
BBBBBBBBBBBPBBBBBBBBBBBB
BBBBBBBBBBBBBBMBBBBBBBBB
BBBBBBBBBBBBBBBBBBBBBBBB